1011111111
1000EPC001
1111111111