11111111111
1000C0P0E011
11111111111