111111
1P0001

111101
1C0E01
111111