111111111111
1000CPE000Z1
111111111111