1111111111
10000PE001
1111111111