1111111111
1010010011
10C10C1011
1010010011
1001001011
1010010011
1001001011
101001C011
1001001011
10100100C1
1001001001
1010010001
1001001001
1P00000001
1E00000001
1010010001
10C10010C1
1010010011
1001001011
1010010011
10C1001011
1111111111