11111111111
10010010001
10001001001
1001001C001
110C1001011
11010010011
11001001011
11010010011
11001001001
110000000P1
11C000000E1
11010010001
11001001011
1001001C011
100C1001011
10010010011
10001001001
11111111111