1111111111111
1001001001001
1000100100101
1001001001C01
1100100100101
1101001001001
1100100100101
1101001001001
1000100100101
1P00000000001
1E00000000001
1001001001001
1100100100101
1101001001001
1000100100101
1001001001001
1000100100101
1111111111111