1111111111111111
1000000000000001
100001C1C1000001
10001C101C000001
1000000000000001
101001010101C101
10101010101C1001
1000000000000001
101C010101C10101
1010101010101001
1000000000000001
10P0010101010101
10E0101010101001
1000000000000001
1010C1C101010101
10101010101C1001
1000000000000001
101001C10101C101
1010101C10101001
1000000000000001
1000111111111101
10000000CCC00001
1111111111111111