111111111111
101111110001
100000000001
10C101010101
101010101001
100000000001
100101010101
1010101C1001
1000000000E1
100101010101
101C10101001
1000000000P1
100101010101
101C10101001
100000000001
1001C1C1C101
101010101001
100000000001
101111111101
111111111111